// Maze for the game.
// This maze file is ignores all the lines starting with `//` in the top.
// Cell Type To Integer Map:
// TBD.
// For, the maze has to be 31x28. TODO: Fix this.
01 02 02 02 02 02 02 02 02 02 02 02 02 08 08 02 02 02 02 02 02 02 02 02 02 02 02 03 
06 00 00 00 00 00 00 00 00 00 00 00 00 07 07 00 00 00 00 00 00 00 00 00 00 00 00 06 
06 00 10 02 02 11 00 10 02 02 02 11 00 07 07 00 10 02 02 02 11 00 10 02 02 11 00 06 
06 00 07 00 00 07 00 07 00 00 00 07 00 07 07 00 07 00 00 00 07 00 07 00 00 07 00 06 
06 00 09 02 02 12 00 09 02 02 02 12 00 09 12 00 09 02 02 02 12 00 09 02 02 12 00 06 
06 00 00 00 00 00 00 00 00 00 00 00 00 00 00 00 00 00 00 00 00 00 00 00 00 00 00 06 
06 00 10 02 02 11 00 10 11 00 10 02 02 02 02 02 02 11 00 10 11 00 10 02 02 11 00 06 
06 00 09 02 02 12 00 07 07 00 09 02 02 11 10 02 02 12 00 07 07 00 09 02 02 12 00 06 
06 00 00 00 00 00 00 07 07 00 00 00 00 07 07 00 00 00 00 07 07 00 00 00 00 00 00 06 
06 00 00 00 00 00 00 07 09 02 02 11 00 07 07 00 10 02 02 12 07 00 00 00 00 00 00 06 
06 00 00 00 00 00 00 07 10 02 02 12 00 09 12 00 09 02 02 11 07 00 00 00 00 00 00 06 
06 00 00 00 00 00 00 07 07 00 00 00 00 00 00 00 00 00 00 07 07 00 00 00 00 00 00 06 
06 00 00 00 00 00 00 07 07 00 00 00 00 00 00 00 00 00 00 07 07 00 00 00 00 00 00 06 
06 00 00 00 00 00 00 09 12 00 00 00 00 00 00 00 00 00 00 09 12 00 00 00 00 00 00 06 
06 00 00 00 00 00 00 00 00 00 00 00 00 00 00 00 00 00 00 00 00 00 00 00 00 00 00 06 
06 00 00 00 00 00 00 00 00 00 00 00 00 00 00 00 00 00 00 00 00 00 00 00 00 00 00 06 
06 00 00 00 00 00 00 00 00 00 00 00 00 00 00 00 00 00 00 00 00 00 00 00 00 00 00 06 
06 00 00 00 00 00 00 00 00 00 00 00 00 00 00 00 00 00 00 00 00 00 00 00 00 00 00 06 
06 00 00 00 00 00 00 00 00 00 00 00 00 00 00 00 00 00 00 00 00 00 00 00 00 00 00 06 
06 00 00 00 00 00 00 00 00 00 00 00 00 00 00 00 00 00 00 00 00 00 00 00 00 00 00 06 
06 00 00 00 00 00 00 00 00 00 00 00 00 00 00 00 00 00 00 00 00 00 00 00 00 00 00 06 
06 00 00 00 00 00 00 00 00 00 00 00 00 00 00 00 00 00 00 00 00 00 00 00 00 00 00 06 
06 00 00 00 00 00 00 00 00 00 00 00 00 00 00 00 00 00 00 00 00 00 00 00 00 00 00 06 
06 00 00 00 00 00 00 00 00 00 00 00 00 00 00 00 00 00 00 00 00 00 00 00 00 00 00 06 
06 00 00 00 00 00 00 00 00 00 00 00 00 00 00 00 00 00 00 00 00 00 00 00 00 00 00 06 
06 00 00 00 00 00 00 00 00 00 00 00 00 00 00 00 00 00 00 00 00 00 00 00 00 00 00 06 
06 00 00 00 00 00 00 00 00 00 00 00 00 00 00 00 00 00 00 00 00 00 00 00 00 00 00 06 
06 00 00 00 00 00 00 00 00 00 00 00 00 00 00 00 00 00 00 00 00 00 00 00 00 00 00 06 
06 00 00 00 00 00 00 00 00 00 00 00 00 00 00 00 00 00 00 00 00 00 00 00 00 00 00 06 
06 00 00 00 00 00 00 00 00 00 00 00 00 00 00 00 00 00 00 00 00 00 00 00 00 00 00 06 
04 02 02 02 02 02 02 02 02 02 02 02 02 02 02 02 02 02 02 02 02 02 02 02 02 02 02 05 