// "The" Maze.
// The integer -> cell equivalent can be found within `cell.h`.
// The maze has to be 31x28. TODO: Update the code to have have a flexible maze.
// TODO: Add a guide here on creating custom mazes.
01 02 02 02 02 02 02 02 02 02 02 02 02 08 08 02 02 02 02 02 02 02 02 02 02 02 02 03 
06 13 13 13 13 13 13 13 13 13 13 13 13 07 07 13 13 13 13 13 13 13 13 13 13 13 13 06 
06 13 10 02 02 11 13 10 02 02 02 11 13 07 07 13 10 02 02 02 11 13 10 02 02 11 13 06 
06 14 07 00 00 07 13 07 00 00 00 07 13 07 07 13 07 00 00 00 07 13 07 00 00 07 14 06 
06 13 09 02 02 12 13 09 02 02 02 12 13 09 12 13 09 02 02 02 12 13 09 02 02 12 13 06 
06 13 13 13 13 13 13 13 13 13 13 13 13 13 13 13 13 13 13 13 13 13 13 13 13 13 13 06 
06 13 10 02 02 11 13 10 11 13 10 02 02 02 02 02 02 11 13 10 11 13 10 02 02 11 13 06 
06 13 09 02 02 12 13 07 07 13 09 02 02 11 10 02 02 12 13 07 07 13 09 02 02 12 13 06 
06 13 13 13 13 13 13 07 07 13 13 13 13 07 07 13 13 13 13 07 07 13 13 13 13 13 13 06 
06 02 02 02 02 11 13 07 09 02 02 11 13 07 07 13 10 02 02 12 07 13 10 02 02 02 02 06 
06 00 00 00 00 07 13 07 10 02 02 12 13 09 12 13 09 02 02 11 07 13 07 00 00 00 00 06 
06 00 00 00 00 07 13 07 07 00 00 00 00 00 00 00 00 00 00 07 07 13 07 00 00 00 00 06 
06 00 00 00 00 07 13 07 07 00 00 00 00 00 00 00 00 00 00 07 07 13 07 00 00 00 00 06 
06 00 00 00 00 07 13 09 12 00 00 00 00 00 00 00 00 00 00 09 12 13 07 00 00 00 00 06 
06 00 00 00 00 07 13 13 13 00 00 07 00 00 00 00 07 00 00 13 13 13 07 00 00 00 00 06 
06 00 00 00 00 07 13 10 11 00 00 07 00 00 00 00 07 00 00 10 11 13 07 00 00 00 00 06 
06 00 00 00 00 07 13 07 07 00 00 09 02 02 02 02 12 00 00 07 07 13 07 00 00 00 00 06 
06 00 00 00 00 07 13 07 07 00 00 00 00 00 00 00 00 00 00 07 07 13 07 00 00 00 00 06 
06 00 00 00 00 07 13 07 07 13 10 02 02 02 02 02 02 11 13 07 07 13 07 00 00 00 00 06 
06 02 02 02 02 12 13 09 12 13 09 02 02 11 10 02 02 12 13 09 12 13 09 02 02 02 02 06 
06 13 13 13 13 13 13 13 13 13 13 13 13 07 07 13 13 13 13 13 13 13 13 13 13 13 13 06 
06 13 10 02 02 11 13 10 02 02 02 11 13 07 07 13 10 02 02 02 11 13 10 02 02 11 13 06 
06 13 09 02 11 07 13 09 02 02 02 12 13 09 12 13 09 02 02 02 12 13 07 10 02 12 13 06 
06 13 13 13 07 07 13 13 13 13 13 13 13 00 13 13 13 13 13 13 13 13 07 07 13 13 13 06 
06 02 11 13 07 07 13 10 11 13 10 02 02 02 02 02 02 02 02 02 11 13 07 07 13 10 02 06 
06 02 12 13 09 12 13 07 07 13 09 02 02 02 11 10 02 02 02 02 12 13 09 12 13 09 02 06 
06 13 13 13 13 13 13 07 07 13 13 13 13 13 07 07 13 13 13 13 13 13 13 13 13 13 13 06 
06 14 10 02 02 02 02 12 09 02 02 02 11 13 07 07 13 10 02 02 02 02 02 02 02 11 14 06 
06 13 09 02 02 02 02 02 02 02 02 02 12 13 09 12 13 09 02 02 02 02 02 02 02 12 13 06 
06 13 13 13 13 13 13 13 13 13 13 13 13 13 13 13 13 13 13 13 13 13 13 13 13 13 13 06 
04 02 02 02 02 02 02 02 02 02 02 02 02 02 02 02 02 02 02 02 02 02 02 02 02 02 02 05 